stts	status
cntr	centre
smpl	sample
strng	string
bcm	became
orgn	origin
crs	cruise
frms	frames
frgt	forget
exprt	export
thms	themes
bttl	bottle
grg	garage
thngs	thongs
chs	cheese
fllw	fellow
prsn	prison
fstr	foster
pckt	packet
grdn	gordon
plc	palace
thrt	throat
lttr	latter
cls	clause
trcks	trucks
shrts	shorts
frmd	framed
mtrs	meters
strk	stroke
dcd	decade
frmr	farmer
ttls	totals
lvng	loving
mrgn	margin
thnks	thinks
trcks	tricks
bttr	butter
pckd	packed
brks	brooks
vctr	victor
trls	trails
shld	shield
scrd	scored
strt	stuart
prd	parade
styls	stylus
chcks	chicks
strct	strict
vlm	valium
ltn	latino
mtls	motels
mrn	marina
prs	pursue
ntn	notion
chrs	cheers
sndr	sandra
mnc	monaco
clr	cooler
brds	breeds
grnd	grande
chrs	chorus
clr	claire
marn	marion
clcks	clicks
frly	freely
schm	schema
hrld	harold
strn	saturn
plns	planes
stcks	sticks
hrly	harley
crts	curtis
dnl	denial
rss	raises
bllt	ballot
angl	angela
grds	guards
pstr	pastor
ballt	ballet
rds	radios
nvd	nvidia
ptt	petite
brks	brakes
std	suited
blcks	blacks
grc	garcia
metrs	metres
rts	ratios
blds	blades
vyr	voyuer
grmn	garmin
mdn	maiden
scrd	scared
marin	marino
bttr	bitter
plts	pilots
cllr	caller
rgn	reagan
snr	sooner
dmn	domino
angls	angles
mnl	manila
prly	purely
dmn	daemon
strs	stairs
zmb	zombie
ltn	lotion
bkng	biking
prt	pirate
csn	cousin
crr	carrie
brtn	barton
strps	straps
shrs	shores
thms	thames
bnn	bonnie
abrd	aboard
erp	europa
fndr	fender
dpr	diaper
dply	deploy
regn	regina
rtl	ritual
mrly	marley
mrtn	morton
grns	grains
cpr	copier
lttr	litter
ptrl	petrol
frng	fringe
manl	manuel
lvly	lively
pnts	paints
brnd	brenda
prd	purdue
ftr	footer
fdr	feeder
hnsn	hanson
tlnt	telnet
wlls	wallis
rtr	retire
wshd	wished
tckr	ticker
wvr	weaver
kllr	keller
flds	fluids
brns	brains
slps	slopes
dnt	denote
sprs	spares
rbt	reboot
trts	traits
gn	guiana
rld	relied
dnd	dundee
strk	streak
mdls	medals
hmmr	hummer
twn	tawnee
dbl	diablo
std	seated
srs	sirius
vrss	verses
brkr	barker
slds	solids
crvd	curved
brds	brides
msss	misses
cllr	cellar
lgn	legion
pstl	pistol
spcs	spices
ldr	loader
strt	strait
tnns	tonnes
rsd	reside
lstd	lasted
frnc	franco
crs	coarse
cntr	contra
marn	maroon
mrrw	marrow
mrcs	marcos
hdd	hooded
snt	sonata
stcks	stacks
lgn	lagoon
rdm	readme
pgn	pigeon
angel	angelo
insst	insest
crps	corpse
wrnr	werner
bsd	biased
chng	chiang
whls	whales
prty	parity
grps	grapes
ddly	dudley
hrn	heroin
brgr	berger
dmnd	damned
blnds	blends
hvn	havana
jnn	jeanne
shts	shoots
clvr	clover
lstr	lester
rvs	reeves
bstr	bistro
rngr	ringer
centr	centro
wstn	westin
brly	barley
ptnt	potent
mdm	madame
tvl	tivoli
dns	denies
sprs	spires
slds	salads
cnn	canine
fllr	filler
str	satire
rdr	raider
tmrs	timers
mnrs	miners
cld	cooled
flds	floods
rprt	rupert
shrn	shrine
jnn	joanna
crl	creole
pssd	pissed
vrtx	vortex
thrn	tehran
msc	musica
mntl	mantle
snts	santos
csd	ceased
sph	sophia
eln	eileen
prd	poured
mstr	mister
strts	struts
jngl	jingle
trs	taurus
stks	stokes
brnch	brunch
mns	monies
pnt	pointe
flrs	flores
glr	galore
prs	persia
mdn	medina
crss	crises
mln	malone
brrw	barrow
excs	excise
csl	causal
sln	saline
thrs	theres
wndr	wander
pnt	pantie
crtr	crater
bsts	beasts
mllr	muller
sandr	sander
pstl	pastel
marin	marian
hrly	hurley
brn	bernie
sttn	staten
crl	carole
bnkr	bunker
lsrs	losers
tld	tailed
mcky	mackay
bns	bonsai
spks	spikes
stns	stains
hngr	hanger
lndn	linden
pard	paired
ccs	caucus
lckd	lacked
brns	bruins
hd	hoodia
rlly	reilly
drng	daring
ltrs	litres
mrln	marlin
thss	theses
wltn	wilton
hstl	hustle
spars	sparse
dmg	dimage
hrmn	harman
clrs	clears
lrsn	larsen
mnc	menace
drms	dramas
regn	regain
sldr	slider
mnr	manure
svr	savior
blnc	blanco
dmd	doomed
blld	ballad
ncl	nuclei
bttr	batter
stls	steals
prc	pearce
crss	crosse
rply	ripley
spds	spades
damn	damien
strd	stared
opnd	openid
prst	preset
psd	poised
tppd	tapped
wsly	wisely
stks	steaks
txns	toxins
cmr	camaro
lgnd	ligand
dnrs	diners
hndl	handel
ttrs	tetris
shots	shouts
stlls	stalls
bndr	bender
rtd	routed
accnt	account
prvt	private
cmpr	compare
prvd	provide
scnc	science
lkng	looking
rls	release
mtng	meeting
mlln	million
strs	stories
cntrl	central
cncl	council
mnts	minutes
rdng	reading
vrs	various
mchl	michael
smn	someone
crtn	certain
lsbn	lesbian
crss	courses
ftr	feature
statn	station
prnts	parents
chns	chinese
cntry	century
prtn	protein
dfnd	defined
grg	georgia
crrs	careers
mscl	musical
angls	angeles
actn	auction
spcs	species
mntr	monitor
lthr	leather
ptnt	patient
blnc	balance
brght	brought
dmnd	diamond
hrng	hearing
entrs	entries
srs	serious
fndng	finding
contr	counter
rdrs	readers
sttl	seattle
indn	indiana
prmt	promote
rlty	reality
thtr	theater
cntn	contain
mnng	meaning
skng	seeking
flng	feeling
rmns	remains
mdls	modules
trbl	trouble
lvng	leaving
bkng	booking
prtn	portion
brtn	britain
thrds	threads
prpr	prepare
prmr	premier
frml	formula
brgn	bargain
crtn	cartoon
brbr	barbara
rvrs	reverse
sttng	sitting
strng	strange
mntn	mention
dmns	domains
mssg	massage
crss	cruises
ldng	loading
appls	applies
strts	streets
albrt	alberta
stds	studios
crts	creates
trst	tourist
vstd	visited
cnsl	counsel
whrs	whereas
prtl	partial
cstl	coastal
hngry	hungary
phlps	philips
bldr	builder
cntrs	centres
fndd	founded
trnd	trained
dvrs	diverse
rsng	raising
chrl	charlie
frncs	francis
appls	appeals
tng	teenage
scrd	secured
rtn	routine
wrng	wearing
pssng	pissing
rmn	romania
fdng	feeding
isrl	israeli
prcd	proceed
fndr	founder
dspt	dispute
prfm	perfume
rstr	restore
crtr	creator
crt	croatia
cstm	costume
pntd	painted
ntrl	neutral
bddng	bedding
hdng	heading
brng	bearing
lctr	locator
clng	ceiling
rtng	routing
pants	panties
sldr	soldier
crcl	crucial
ppls	peoples
exprts	exports
slmn	solomon
fllng	filling
trnr	trainer
mxtr	mixture
estn	estonia
strms	streams
prr	prairie
rnn	reunion
sprts	spirits
vrss	viruses
lsng	leasing
mrtl	martial
clrs	colours
exct	execute
dfns	defines
rtrs	routers
csn	cuisine
blv	bolivia
crs	curious
crr	courier
clsr	closure
hrmn	hormone
andrs	andreas
cptl	capitol
nrvs	nervous
rplc	replica
hrbr	harbour
prcs	precise
frmng	forming
lndng	lending
snst	soonest
armn	armenia
rvls	reveals
carrs	carries
snrs	sunrise
adptd	adapted
flng	failing
blln	balloon
rchs	reaches
plnts	planets
dfct	deficit
bldr	boulder
ctn	caution
prts	pirates
orgns	origins
albn	albania
lstng	lasting
lwst	lawsuit
clmn	coleman
prps	propose
rfnd	refined
prdct	predict
ngr	niagara
trst	trustee
ctng	coating
clrd	cleared
smls	smilies
btng	boating
shkr	shakira
brdr	broader
mlg	mileage
adptr	adaptor
frmng	framing
pckng	picking
pckts	pockets
sngl	senegal
mrcl	miracle
rbts	rebates
lbr	liberia
sttng	stating
lckng	locking
prst	pursuit
prsn	persian
grnd	grenada
sml	somalia
ertc	erotica
strps	stripes
cmpt	compute
wshng	wishing
ftg	fatigue
bttls	battles
brnd	burundi
grnt	granite
advsr	adviser
crtn	curtain
btng	beating
dytn	daytona
thrn	therein
brkn	burkina
lckng	lacking
persn	pearson
dcds	decides
cptn	caption
agst	augusta
francs	frances
dbts	debates
bstr	booster
mlr	malaria
trrr	terrier
sctr	scooter
tmt	timeout
frfx	fairfax
marian	mariana
rfg	refugee
stnd	stained
martl	marital
cnfrm	conform
pntr	painter
stppd	stepped
fllws	fellows
mnsn	mansion
cmrs	comoros
brth	breathe
chrst	charset
mrc	maurice
slvs	sleeves
strng	storing
blnds	blondes
ltrl	literal
crsr	cruiser
strks	strokes
spkn	spokane
hstl	hostile
lrnt	laurent
tstng	tasting
smplr	sampler
trvl	trivial
clss	clauses
rbrt	roberto
hnrs	honours
sclr	secular
vlt	violate
rels	realise
rdrs	raiders
pllng	polling
vntr	ventura
fthr	feather
michl	michele
contr	contour
resd	residue
gds	goodies
trbn	turbine
chrst	christi
impls	impulse
gtwy	getaway
rvr	riviera
prms	premise
psss	pussies
prtn	preteen
bndng	bonding
frnc	furnace
prsns	prisons
brdly	broadly
prsns	parsons
bndd	bounded
tchs	touches
mln	melanie
trn	trainee
nlsn	nielsen
stats	statues
rbbns	ribbons
pantr	pantera
ovrly	overlay
amtr	amature
brndn	brendan
blng	boiling
ncls	nicolas
dctr	decatur
cld	claudia
clr	calorie
frthr	farther
lndsy	lindsey
jnr	janeiro
bttng	batting
amatr	amatuer
strng	staring
bndng	bending
htls	hoteles
trnd	tornado
cstng	costing
thrt	thereto
mrtn	martini
cstr	coaster
grand	granada
sntr	sinatra
ntns	notions
plt	plateau
clrn	celeron
marn	maureen
pilts	pilates
blgn	bologna
accrd	accrued
dltd	diluted
lng	lineage
vghn	vaughan
slng	sealing
mgnt	magenta
wrght	wrought
thers	theresa
vcs	vicious
lnng	leaning
cmps	compose
crshd	crashed
flmng	filming
crtr	cartier
bllts	ballots
gntl	genital
krstn	kristen
mullr	mueller
stfn	stefani
brkr	breaker
albert	alberto
cllg	collage
jls	jealous
csns	cousins
grg	giorgio
txtl	textual
trsm	turismo
rmns	ramones
arcd	arcadia
rngng	ringing
whsky	whiskey
strd	steroid
olvr	olivier
rcrd	ricardo
colrs	coolers
tstr	toaster
strss	strauss
hvr	heavier
slmn	salomon
prsd	praised
brdr	breeder
pstr	posture
thern	thereon
pddng	pudding
glmr	gilmore
dlng	dialing
elctr	electra
prcd	pierced
frs	fairies
pnts	peanuts
frrs	ferries
ernst	earnest
flmng	flaming
dpst	deepest
grll	gorilla
pastr	pasture
slrs	sailors
flvr	flavour
wtchs	witches
mlt	militia
hppr	happier
stckd	stacked
sctn	suction
crsd	crusade
nvll	neville
prst	poorest
frmn	foreman
crrr	carrera
trnt	turnout
rnwy	runaway
clst	coolest
mstr	maestro
tppng	tipping
galr	galerie
brntt	burnett
lttc	lettuce
arbc	aerobic
fldd	flooded
crsr	corsair
excss	excuses
cmmt	commute
drng	durango
allgr	allegra
vrts	virtues
krstn	kirsten
cllr	collier
dntd	denoted
grgs	garages
vntg	vantage
stphn	stephan
lngr	lingere
ndls	noodles
fctn	faction
astr	astoria
shppng	shopping
prvs	previous
trnng	training
ftrs	features
plcs	policies
pstn	position
dscnt	discount
contn	continue
strdy	saturday
vrgn	virginia
ptnts	patients
mntn	mountain
fmls	families
emply	employee
clrd	colorado
fclty	facility
mnstr	minister
accnts	accounts
actns	auctions
mtrl	motorola
sprt	separate
vrbl	variable
mntn	maintain
crtr	criteria
lingr	lingerie
brkng	breaking
crtn	creation
clnng	cleaning
victr	victoria
stbl	suitable
dbts	diabetes
cnts	counties
cncrt	concrete
mntrs	monitors
prsnt	pursuant
grdn	guardian
rcvr	receiver
mmrs	memories
blvd	believed
rvns	revenues
prds	paradise
prtns	portions
chsng	choosing
pttn	petition
dlg	dialogue
rmnd	remained
flngs	feelings
dntn	donation
clmb	colombia
strng	steering
cntrs	counters
cchng	coaching
dmnds	diamonds
sttd	situated
anlyss	analyses
cttn	citation
precs	precious
chpst	cheapest
thers	theories
exctd	executed
brntt	brunette
prtcl	particle
cstms	costumes
slvk	slovakia
grgs	gorgeous
clnl	colonial
mstr	moisture
trsts	trustees
nchls	nicholas
prdc	periodic
brdng	breeding
rttn	rotation
premr	premiere
infnt	infinite
itln	italiano
prmss	promises
pntng	pointing
flrs	failures
dtsch	deutsche
salrs	salaries
drng	drainage
rtns	routines
frwr	firewire
cntrd	centered
cmrn	cameroon
invsn	invision
gnrs	generous
strngr	stranger
bldng	bleeding
crln	caroline
intrnt	intranet
thrgh	thorough
cretr	creature
prmts	promotes
lcns	licensee
trsts	tourists
mntry	monterey
scrng	securing
spcs	spacious
fndng	founding
clrs	calories
nttn	notation
crng	carnegie
dmnc	dominica
prcng	piercing
srnm	suriname
brdng	boarding
dltn	deletion
tchng	touching
prsng	pursuing
vlnc	valencia
prpss	proposes
colrd	coloured
slcn	silicone
lghtr	laughter
rsds	residues
fldng	flooding
thtrs	theatres
clrng	coloring
bllns	billions
adptrs	adaptors
cmprs	compares
crtns	curtains
cmpss	campuses
stppng	stepping
trckng	trucking
frmnt	fairmont
brngs	bearings
sndng	sounding
dscrt	discreet
advsrs	advisers
crtn	croatian
prsr	presario
clmnt	claimant
rpld	repealed
sctrs	scooters
rlsd	realised
frtn	fourteen
thrtn	threaten
brdrs	breeders
rgrs	rigorous
frwll	farewell
frctn	friction
comprs	comprise
sbttl	subtitle
infint	infiniti
christ	christie
anntt	annotate
mtrng	metering
mtrcs	matrices
clns	colonies
vrnc	veronica
sndrs	saunders
grtt	gratuite
trts	treaties
andrsn	andersen
cffn	caffeine
anlg	analogue
clst	closeout
stckng	sticking
mscls	musicals
concrt	concerto
frbs	freebies
grdnr	gardener
plcng	policing
spnnng	spanning
francs	francais
attnd	attained
lnrd	leonardo
prvnc	provence
dmnt	dementia
strlng	stirling
francs	francois
pntrs	painters
fthrs	feathers
mhmmd	mohammed
assrtd	asserted
cncld	canceled
orgns	organise
vlts	violates
gtwys	getaways
appld	appealed
strrng	stirring
prntl	prenatal
prdcts	predicts
brkrs	breakers
prsd	persuade
fldng	fielding
dfcts	deficits
cretn	creatine
trns	trainees
cts	cautious
emrts	emeritus
sybn	siyabona
prtr	pretoria
frshmn	freshmen
dcdng	decoding
prfr	purifier
undrg	underage
crltn	carleton
stffng	stuffing
cmpld	complied
seprt	seperate
flshng	flushing
frwrd	foreword
bllrd	billiard
prstn	pristine
appls	applause
pndng	pounding
prvn	peruvian
mrnng	mourning
tcklng	tackling
flamng	flamingo
ptrsn	paterson
ptrsn	petersen
shtng	shouting
cnsrv	conserve
contrs	countries
advrts	advertise
insttt	institute
frntr	furniture
emplys	employees
sttn	situation
grnt	guarantee
ddctd	dedicated
cntnd	contained
pstns	positions
lsn	louisiana
fvrt	favourite
cntns	continues
clrnc	clearance
prmtr	parameter
ctlg	catalogue
indns	indonesia
exprts	expertise
dngrs	dangerous
prncpl	principle
mntns	mountains
bhvr	behaviour
prntng	parenting
hzrds	hazardous
elmnt	eliminate
amnts	amenities
sprtd	separated
drctv	directive
cmpst	composite
scts	societies
chrstn	christina
prtcls	particles
mnstrs	ministers
rvrsd	riverside
cmplnt	compliant
christn	christine
vltn	valuation
mtllc	metallica
mntns	maintains
cmptng	competing
mntr	miniature
centrs	centuries
prmnnt	prominent
mrts	mauritius
crtrs	creatures
stephn	stephanie
dvtn	deviation
qlts	qualities
rmndr	remainder
cstms	customise
scrfc	sacrifice
smmrs	summaries
collg	colleague
trsrs	treasures
crtns	creations
almnm	aluminium
vrts	varieties
cmprss	comprises
chrts	charities
mcdnld	macdonald
rtnl	rationale
lsbns	lesbianas
gntlmn	gentlemen
jdgmnt	judgement
exctng	executing
prmtr	premature
pstcd	pesticide
sltr	solitaire
amrcn	americana
fctrs	factories
alxndr	alexandra
rlts	realities
chmpgn	champaign
pkstn	pakistani
slctr	solicitor
prmtr	perimeter
strtd	saturated
prcdd	proceeded
rghts	righteous
mcknz	mackenzie
wndrng	wandering
rqst	requisite
cncld	concealed
sprts	separates
mnstry	monastery
fshrmn	fishermen
grdns	guardians
mnfst	manifesto
cncrd	concordia
anmls	anomalies
endvr	endeavour
nghbr	neighbour
alexndr	alexandre
predct	predicate
cnslt	consulate
lcnss	licensees
vctrs	victories
rdhd	radiohead
rltns	realtones
francas	francaise
vlntn	valentino
argntn	argentine
chrnc	coherence
frncsc	francesco
fclts	facilities
rstrnt	restaurant
evltn	evaluation
mntrng	monitoring
prmtrs	parameters
mntnd	maintained
grntd	guaranteed
cntnng	continuing
scrts	securities
contns	continuous
inttv	initiative
fvrts	favourites
sttns	situations
cllgs	colleagues
wrrnts	warranties
prcdng	proceeding
prdctn	prediction
grnts	guarantees
indctn	indication
minstrs	ministries
alexandr	alexandria
ygslv	yugoslavia
rvltn	revelation
mystrs	mysterious
bstlty	beastality
antrctc	antarctica
sttnry	stationary
martn	mauritania
ddctn	dedication
sprstr	superstore
inttn	initiation
dlvrs	deliveries
advisrs	advisories
nghbrs	neighbours
prncpls	principals
mntrs	miniatures
prspcts	prospectus
elmnts	eliminates
ctlgs	catalogues
klmtrs	kilometres
prdctv	predictive
msrbl	measurable
plymrs	polymerase
hnrbl	honourable
sprtng	separating
cmplmnt	compliment
cnfrmng	conforming
rpttn	repetition
hypthss	hypotheses
rprtr	repertoire
spclty	speciality
cnvctn	convection
dfntly	definately
fvrbl	favourable
crvs	cerevisiae
chndlr	chandelier
cmmnts	communities
prprtn	preparation
drctrs	directories
bestlty	beastiality
mmrbl	memorabilia
mntnng	maintaining
cmpltn	compilation
prspctv	prospective
clbrts	celebrities
clbrtn	calibration
cmpttn	computation
prdctns	predictions
hmltn	humiliation
dscvrs	discoveries
chttng	chattanooga
stblty	suitability
elctrnc	electronica
prsctn	persecution
prprtry	preparatory
bhvrl	behavioural
cllctbl	collectable
cllctbls	collectables
trnsxls	transexuales
cntntn	continuation
prprtns	preparations
smltns	simultaneous
prfctn	purification
mstrbtng	masterbating
mstrbtn	masterbation
nghbrng	neighbouring
cmplmntry	complementary
nghbrhd	neighbourhood
acknwldgmnts	acknowledgements
